11 11
21111011111
10001111001
11110001111
00011100001
00010111111
01101100100
01001000100
01111100100
01000111111
11000100001
11110000114