15 15 40 10 1
211000111011100
101101101010100
100101001110100
111111101010100
000100111011110
111100101110111
100111111011101
111100101000101
010111101111111
010010100010001
010110111111111
010100010010010
111100111011111
100111101001001
111100111111114