19 19
2111111011111000000
1010100010101000000
1011111110111110000
1010001010001010000
1111111111111011100
1000101000101010100
1110101111101111111
0010101000101010001
1111111011111010111
1000101010001010101
1111101111101111111
1010101010101000101
1110111010111111101
0010001010001010101
0011111111111111111
0000101010101010001
0000111011111011111
0000001010001010101
0000001111111111114