12 12 10 8 2
211110111111
100011101001
111100101111
000111100001
000100111111
011101100100
010001000100
011111100100
001000111111
011000100001
010011111101
011110000114