12 12 40 8 2
211110111111
100011101001
111100101111
000111100001
000100111111
011101101010
010001001010
011111101111
001000111101
011110100101
010011111101
011110000114